アウト	アウト
アウトコース	アウトコース
アウトサイド	アウトサイド
アウトステップ	アウトステップ
アシスト	アシスト
アヘッド	アヘッド
アピール	アピール
アピールプレー	アピールプレー
アベックホームラン	アベックホームラン
アメリカンリーグ	アメリカンリーグ
アルファ勝ち	アルファカチ
アルプススタンド	アルプススタンド
安全進塁権	アンゼンススムルイケン
アンダースロー	アンダースロー
アンツーカー	アンツーカー
イースタンリーグ	イースタンリーグ
イニング	イニング
一本足打法	イッポンアシダホウ
イリーガルピッチ	イリーガルピッチ
イレギュラーバウンド	イレギュラーバウンド
インコース	インコース
インサイド	インサイド
インサイド	インサイド
インサイドワーク	インサイドワーク
インザホール	インザホール
インステップ	インステップ
インターバル	インターバル
引退	インタイ
インハイ	インハイ
インパクト	インパクト
インフィールドフライ	インフィールドフライ
インプレー	インプレー
インロー	インロー
ウイニングショット	ウイニングショット
ウイニングボール	ウイニングボール
ウイニングラン	ウイニングラン
ウェーティングサークル	ウェーティングサークル
ウェーバー	ウェーバー
ウエスタンリーグ	ウエスタンリーグ
ウエストボール	ウエストボール
ウォーニングトラック	ウォーニングトラック
永久欠番	エイキュウケツバン
エキストライニング	エキストライニング
エース	エース
エンタイトルツーベース	エンタイトルツーベース
オーダー	オーダー
オーバースロー	オーバースロー
オーバーフェンス	オーバーフェンス
オーバーラン	オーバーラン
オープニングゲーム	オープニングゲーム
オープンスタンス	オープンスタンス
オープン戦	オープンセン
オールスターゲーム	オールスターゲーム
オールラウンドプレーヤー	オールラウンドプレーヤー
押し出し	オシダシ
オフィシャルルールズ	オフィシャルルールズ
オフィシャルレコード	オフィシャルレコード
オブストラクション	オブストラクション
隠し球	カクシタマ
カーテンレーザー	カーテンレーザー
カード	カード
カーブ	カーブ
カウント	カウント
カバー	カバー
壁	カベ
カラーマン	カラーマン
完全試合	カンゼンジアイ
カンバス	カンバス
完封	カンプウ
キーストーン	キーストーン
キーストンコンビネーション	キーストンコンビネーション
消える魔球	キエルマキュウ
危険球	キケンキュウ
犠打	ギダ
偽投	ニセトウ
逆指名	ギャクシメイ
キャッチ	キャッチ
キャッチボール	キャッチボール
キャッチャー	キャッチャー
キャッチャーズボックス	キャッチャーズボックス
キャッチング	キャッチング
キャプテン	キャプテン
キャンバス	キャンバス
キャンプ	キャンプ
キャンプイン	キャンプイン
救援投手	キュウエントウシュ
挟殺プレー	キョウサツプレー
キラー	キラー
クイックモーション	クイックモーション
クッションボール	クッションボール
クラウチングスタイル	クラウチングスタイル
グラウンダー	グラウンダー
グラウンドキーパー	グラウンドキーパー
クラッチヒッター	クラッチヒッター
グラブ	グラブ
グランド	グランド
グランドスラム	グランドスラム
クリーンアップ	クリーンアップ
クリーンヒット	クリーンヒット
グリップ	グリップ
グリップエンド	グリップエンド
クローズドスタンス	クローズドスタンス
グローブ	グローブ
クロスゲーム	クロスゲーム
クロスファイア	クロスファイア
クロスプレー	クロスプレー
敬遠	ケイエン
ケージ	ケージ
ゲーム差	ゲームサ
ゲームセット	ゲームセット
ゲッツー	ゲッツー
硬球	コウキュウ
甲子園大会	コウシエンタイカイ
コーチ	コーチ
コーチズボックス	コーチズボックス
コーナー	コーナー
コーナーワーク	コーナーワーク
ゴールデングラブ賞	ゴールデングラブショウ
コールドゲーム	コールドゲーム
国際野球協会	コクサイヤキュウキョウカイ
ゴロ	ゴロ
コミッショナー	コミッショナー
コントロール	コントロール
コンバート	コンバート
コンビネーション	コンビネーション
サード	サード
サイクルヒット	サイクルヒット
サイドアームスロー	サイドアームスロー
サイドステップ	サイドステップ
サイドスロー	サイドスロー
サイン	サイン
サインプレー	サインプレー
サウスポー	サウスポー
サクリファイスバント	サクリファイスバント
サスペンデッドゲーム	サスペンデッドゲーム
サブマリン	サブマリン
サブマリンピッチャー	サブマリンピッチャー
シーズンオフ	シーズンオフ
シーソーゲーム	シーソーゲーム
シート	シート
シートノック	シートノック
四球	シキュウ
死球	シキュウ
軸足	ジクアシ
四死球	シシキュウ
自責点	ジセキテン
シフト	シフト
指名打者	シメイダシャ
社会人野球選手権大会	シャカイジンヤキュウセンシュケンタイカイ
ジャストミート	ジャストミート
ジャッグル	ジャッグル
シャットアウト	シャットアウト
シャドープレー	シャドープレー
首位打者	シュイダシャ
自由契約選手	ジユウケイヤクセンシュ
終速	オワリソク
シュート	シュート
勝率	ショウリツ
ショート	ショート
ショートストップ	ショートストップ
ショートバウンド	ショートバウンド
ショートリリーフ	ショートリリーフ
初速	ショソク
シリーズ	シリーズ
シンカー	シンカー
シングルヒット	シングルヒット
スイッチヒッター	スイッチヒッター
スイフト	スイフト
スイングアウト	スイングアウト
スウイング	スウイング
スクイズ	スクイズ
スクエアスタンス	スクエアスタンス
スクラッチヒット	スクラッチヒット
スクリューボール	スクリューボール
スコア	スコア
スコアキーパー	スコアキーパー
スコアブック	スコアブック
スコアボード	スコアボード
スコアラー	スコアラー
スコアリングポジション	スコアリングポジション
スコンク	スコンク
スターティングメンバー	スターティングメンバー
スタンス	スタンス
スタンドプレー	スタンドプレー
スチール	スチール
ストーブリーグ	ストーブリーグ
ストッパー	ストッパー
ストライク	ストライク
ストライクアウト	ストライクアウト
ストライクゾーン	ストライクゾーン
ストライド	ストライド
スナップ	スナップ
スパイク	スパイク
スピードガン	スピードガン
スピットボール	スピットボール
スプリットフィンガードファーストボール	スプリットフィンガードファーストボール
スモークボール	スモークボール
スライダー	スライダー
スライディング	スライディング
スラッガー	スラッガー
スラッギングアベレージ	スラッギングアベレージ
スランプ	スランプ
３Ａ	３Ａ
スリークォーター	スリークォーター
スリーバント	スリーバント
スリーフィートライン	スリーフィートライン
スロー	スロー
スローイング	スローイング
セーフ	セーフ
セーブ	セーブ
セーフティバント	セーフティバント
セーブポイント	セーブポイント
セオリープレー	セオリープレー
セカンド	セカンド
ゼネラルマネージャー	ゼネラルマネージャー
セリーグ	セリーグ
全国高等学校野球選手権大会	ゼンコクコウトウガッコウヤキュウセンシュケンタイカイ
センター	センター
セントラルリーグ	セントラルリーグ
選抜高等学校野球大会	センバツコウトウガッコウヤキュウタイカイ
先発ローテーション	センパツローテーション
走塁妨害	ソウルイボウガイ
ソロホームラン	ソロホームラン
タイ	タイ
タイ記録	タイキロク
タイゲーム	タイゲーム
タイスコア	タイスコア
代走	ダイソウ
代打	ダイダ
タイトルホルダー	タイトルホルダー
タイム	タイム
タイムリーエラー	タイムリーエラー
タイムリーヒット	タイムリーヒット
ダイヤモンド	ダイヤモンド
ダイヤモンドグラブ賞	ダイヤモンドグラブショウ
大リーグ	ダイリーグ
代理人交渉	ダイリニンコウショウ
ダイレクト	ダイレクト
ダウン	ダウン
ダウンスウィング	ダウンスウィング
打者席	ダシャセキ
打者走者	ダシャソウシャ
打順	ダジュン
打数	ダスウ
ダスター	ダスター
ダッグアウト	ダッグアウト
タッチ	タッチ
タッチアウト	タッチアウト
タッチアップ	タッチアップ
打点	ダテン
ダブル	ダブル
ダブルスコア	ダブルスコア
ダブルスチール	ダブルスチール
ダブルプレー	ダブルプレー
ダブルヘッダー	ダブルヘッダー
打率	ダリツ
チェンジ	チェンジ
チェンジアップ	チェンジアップ
チップ	チップ
直球	チョッキュウ
ティーバッティング	ティーバッティング
テイクバック	テイクバック
テークバック	テークバック
デッドヒート	デッドヒート
デッドボール	デッドボール
盗塁	トウルイ
ドーム球場	ドームキュウジョウ
ドクターＫ	ドクターＫ
都市対抗野球	トシタイコウヤキュウ
トスバッティング	トスバッティング
ドラッグバント	ドラッグバント
ドラフト制	ドラフトセイ
トリックプレー	トリックプレー
トリプルＡ	トリプルＡ
トリプルクラウン	トリプルクラウン
トレード	トレード
トレードマネー	トレードマネー
ドロー	ドロー
ナイター	ナイター
内野	ナイヤ
内野安打	ナイヤアンダ
ナイン	ナイン
ナショナルリーグ	ナショナルリーグ
ナックルボール	ナックルボール
軟式野球	ナンシキヤキュウ
日米大学野球選手権	ニチベイダイガクヤキュウセンシュケン
日本高等学校野球連盟	ニッポンコウトウガッコウヤキュウレンメイ
日本シリーズ	ニッポンシリーズ
日本選手権	ニホンセンシュケン
日本野球連盟	ニホンヤキュウレンメイ
ノーゲーム	ノーゲーム
ノータッチ	ノータッチ
ノーヒットノーランゲーム	ノーヒットノーランゲーム
ノープレー	ノープレー
ノーワインドアップ	ノーワインドアップ
ノッカー	ノッカー
ノックアウト	ノックアウト
パーフェクトゲーム	パーフェクトゲーム
ハーフスイング	ハーフスイング
パームボール	パームボール
ハーラーダービー	ハーラーダービー
パシフィックリーグ	パシフィックリーグ
バスター	バスター
バックアップ	バックアップ
バックス	バックス
バックスクリーン	バックスクリーン
バックスピン	バックスピン
バックナンバー	バックナンバー
バックネット	バックネット
バッター	バッター
バッターインザホール	バッターインザホール
バッターボックス	バッターボックス
バッターランナー	バッターランナー
バッティング	バッティング
バッティングアベレージ	バッティングアベレージ
バッティングオーダー	バッティングオーダー
バッティングケージ	バッティングケージ
バッティングセンター	バッティングセンター
バッティングフォーム	バッティングフォーム
バッテリー	バッテリー
バット	バット
パリーグ	パリーグ
バント	バント
バントエンドラン	バントエンドラン
ビーンボール	ビーンボール
ビジター	ビジター
ビジティングチーム	ビジティングチーム
ピックオフプレー	ピックオフプレー
ピッチ	ピッチ
ピッチアウト	ピッチアウト
ピッチドアウト	ピッチドアウト
ピッチャーズプレート	ピッチャーズプレート
ピッチング	ピッチング
ヒッティング	ヒッティング
ヒッティングポイント	ヒッティングポイント
ヒット	ヒット
ヒットエンドラン	ヒットエンドラン
ビハインド	ビハインド
ファースト	ファースト
ファーム	ファーム
ファール	ファール
ファイアマン	ファイアマン
ファウル	ファウル
ファウル地域	ファウルチイキ
ファウルチップ	ファウルチップ
ファウルライン	ファウルライン
ファンブル	ファンブル
フィールディング	フィールディング
フィニッシュ	フィニッシュ
フィルダーズチョイス	フィルダーズチョイス
フェア	フェア
フォアボール	フォアボール
フォークボール	フォークボール
フォースアウト	フォースアウト
プッシュ	プッシュ
フライ	フライ
フランチャイズ	フランチャイズ
フリーエージェント制	フリーエージェントセイ
ブリーチャーズ	ブリーチャーズ
プル	プル
フルカウント	フルカウント
フルベース	フルベース
ブルペン	ブルペン
プレーオフ	プレーオフ
プレート	プレート
プレーボール	プレーボール
ブロック	ブロック
ブロックサイン	ブロックサイン
フロント	フロント
併殺	ヘイサツ
併殺打	ヘイサツダ
ベース	ベース
ベースコーチ	ベースコーチ
ベースライン	ベースライン
ベストナイン	ベストナイン
ヘッドコーチ	ヘッドコーチ
ヘッドスライディング	ヘッドスライディング
ペナントレース	ペナントレース
ベンチウォーマー	ベンチウォーマー
暴投	ボウトウ
ボーク	ボーク
ホースアウト	ホースアウト
ホーム	ホーム
ホームイン	ホームイン
ホームグラウンド	ホームグラウンド
ホームゲーム	ホームゲーム
ホームスチール	ホームスチール
ホームチーム	ホームチーム
ホームラン	ホームラン
ボール	ボール
ボールデッド	ボールデッド
ホールド	ホールド
ボーンヘッド	ボーンヘッド
星	ホシ
ポジション	ポジション
捕手	ホシュ
捕手席	ホシュセキ
ポストシーズン	ポストシーズン
ボックス	ボックス
没収試合	ボッシュウシアイ
ホットコーナー	ホットコーナー
ホップ	ホップ
ポップフライ	ポップフライ
本塁打	ホンルイダ
マイナーリーグ	マイナーリーグ
マウンド	マウンド
魔球	マキュウ
マジックナンバー	マジックナンバー
ミート	ミート
ミスターＫ	ミスターＫ
ミット	ミット
無効試合	ムコウシアイ
名球会	メイタマカイ
メジャーリーグ	メジャーリーグ
モーション	モーション
野球	ヤキュウ
野球殿堂	ヤキュウデンドウ
ライト	ライト
ライトフィールダー	ライトフィールダー
ライトフィールド	ライトフィールド
ライナー	ライナー
ラインアウト	ラインアウト
ラインアップ	ラインアップ
ラッキーゾーン	ラッキーゾーン
ラフプレー	ラフプレー
ラン	ラン
ランダンプレー	ランダンプレー
ランナー	ランナー
ランニングホームラン	ランニングホームラン
リーディングヒッター	リーディングヒッター
リードオフマン	リードオフマン
リトルリーグ	リトルリーグ
リリース	リリース
リリーフピッチャー	リリーフピッチャー
塁	ルイ
ルーキー	ルーキー
レガーズ	レガーズ
レフト	レフト
レフトオンベース	レフトオンベース
レフトフィールダー	レフトフィールダー
レフトフィールド	レフトフィールド
ロージンバック	ロージンバック
ローテーション	ローテーション
ロードゲーム	ロードゲーム
ロスター	ロスター
ロッキングモーション	ロッキングモーション
ロングスイング	ロングスイング
ロングヒット	ロングヒット
ワールドシリーズ	ワールドシリーズ
ワイルドカード	ワイルドカード
ワイルドピッチ	ワイルドピッチ
ワインドアップ	ワインドアップ
ワンポイントリリーフ	ワンポイントリリーフ
Ｂ	ビー
ＤＨ	ディーエイチ
ＦＡ	エフエー
ＦＣ	エフシー
ＧＭ	ジーエム
Ｈ	エイチ
ＩＤ野球	アイディーヤキュウ
ＪＡＢＡ	ジェーエービーエー
Ｋ	ケー
Ｏ	オー
ＰＨ	ピンチヒッター
Ｓ	エス
ＳＦＦ	エスエフエフ
